┌───────────┬───────┐
│           │       │
│           │       │
│           │       │
│           └───────┤
│                   │
│   ┌───/───┐       │
│   │       │   ┌─ ─┤
│   │       │   │   │
│   │       │   │ X │
└───┴───────┴───┴───┘