┌───────────────┬───┐
│               │   │
│      ┌─ ──┐       │
│      │    │   │   │
│      └────┘   └───┤
│                   │
│ ┌─ ─┐             │
│ │   ├─ ──┐    ┌─ ─┤
│ │   │    ├─ ──┤   │
│ │   │    │    │   │
└─┴───┴────┴────┴───┘