┌───────────────┬───┐ ┌─────────────────┬────┬─┐
│               │   │ │                 │    │ │
│      ┌─ ──┐       │ │  ┌───── ─────┐  │      │
│      │    │   │   │ │  │           │  │    │ │
│      └────┘   └───┤ │  └─────┬───┬─┘  └────┘ │
│                   │ │        │   │           │
│ ┌─ ─┐             │ ├────┐   │   │ ┌─── ─────┤
│ │   ├─ ──┐    ┌─ ─┤ │    │       │ │         │
│ │   │    ├─ ──┤   │ │        │   │ │         │
│T│   │    │    │   │ │    │   │   │T│         │
└─┴───┴────┴────┴───┘ └────┴───┴───┴─┴─────────┘